####################
#                  #    
#              S   #    
#                  #    
#                  #    
#                  #    
#                  #    
#                  #    
#                  #    
#                  #    
#                  #    
#                  #    
#                  #    
# ##################
