####################
####################
##   #     #       #
## ### # ### ##### #
##     #       #   #
## ############# # #
##     #   #     # #
###### ### # ##### #
##         # #   # #
## ####### # # # ###
##   #    S#   #   #
#### # ### ####### #
##   #   #   #     #
## ##### ##### ### #
##   #   #   # #   #
#### # ### # # # ###
## # # #   # # #   #
## # # ### # # ### #
##   #     #   #   #
## #################
