########################################################
# # #     #                                            #
#S# # ### # ### ################################## ### #
# # # # # # # # # #    #  #  ## #   #   # #   #E # ### #
#   #   #   # # #   ## ## ## #  # #   # # # # ## # ### #
### ### #####   # ####  #    ##   ##### #   #    #     #
#   # #   #   ###     # #### #  ## #  # # ##############
### # # ### ### #######  # # # #   ##   #      #   #   #
#   #   # # #           #      ###    # #### #   #   # #
# ### # # # ##### ### ### ### ##   #### #  # ######### #
#   # #   #  #    #     #   # #  ##  #  ## #     # #   #
###   ###### # ###### ####### ##  # #### # ####### ## ##
# ### #    # #   # #    #   # #  ##    # #   #   #     #
#     # ##     ###   ##   #   ##    ##     #   #   # # #
########################################################